1,1,1,1,1,1,1,1,1,1,1,1,1,1,1,1
1,1,6,1,1,6,1,1,0,0,1,1,1,1,1,1
1,3,5,1,1,1,1,1,0,1,1,1,1,1,1,2
5,5,6,1,1,1,6,1,1,1,1,1,1,1,2,2
5,5,1,1,6,1,0,2,1,1,2,1,2,2,2,2
5,1,1,1,1,0,1,1,0,1,1,2,2,1,1,1
1,0,1,1,1,1,1,0,1,1,1,2,2,1,1,1
1,1,1,1,1,6,1,1,1,1,2,2,2,1,1,1
1,1,1,1,1,1,1,1,1,1,2,2,1,1,1,1
1,1,1,1,1,2,1,1,1,1,2,2,1,1,1,1
1,1,1,1,1,1,1,1,1,2,2,1,1,1,0,1
5,1,1,1,1,5,5,1,2,2,2,1,1,1,1,1
5,5,5,1,5,3,5,5,2,2,2,1,1,1,1,1
5,3,5,5,5,5,5,2,2,1,1,1,1,1,1,1
5,5,3,5,3,5,5,2,2,1,1,1,1,1,1,1
5,5,5,5,1,5,2,2,1,1,1,1,1,1,1,1
